1111111111
1001C1C011
1P01010001
10000C00E1
1C11000001
1111111111