1111111111
1P000000C1
1110000011
1C111111E1
1000000001
1111111111
