1111111111
10P1C00011
1001010001
10001C00E1
1100000001
1111111111