1111111111111111111111111
1100101001000001000101011
1010010101000100100010101
1P00C00C000000000000000C1
1E00000000C00000C00000001
1011010100100000001000101
1000010100100100100000011
1000000100100001C00010001
1111111111111111111111111